76 76 76 76 76 76 76 76 76 76 76 76 76 76 76 76
76 76 76 76 76 76 76 76 76 76 76 76 76 76 76 76
76 76 121 121 121 121 121 121 121 121 121 121 121 121 76 76
76 76 121 121 121 121 121 121 121 121 121 121 121 121 76 76
76 76 -1 -1 -1 -1 -1 -1 -1 -1 -1 -1 -1 -1 76 76
76 76 121 121 121 121 121 121 121 121 121 121 121 121 76 76
76 76 121 121 121 121 121 121 121 121 121 121 121 121 76 76
76 76 121 121 121 121 121 121 121 121 121 121 121 121 76 76
76 76 121 121 121 121 121 121 121 121 121 121 121 121 76 76
76 76 73 73 73 73 73 121 121 73 73 73 73 73 76 76
76 76 76 76 76 76 76 121 121 76 76 76 76 76 76 76
