76 76 76 76 76 76 76 76 76 76 76 76 76 76 76 76
76 76 76 76 76 76 76 76 76 76 76 76 76 76 76 76
76 76 47 47 47 47 47 47 47 47 47 47 47 47 76 76
76 76 47 47 47 47 47 47 47 47 47 47 47 47 76 76
76 76 -1 -1 -1 -1 -1 -1 -1 -1 -1 -1 -1 -1 76 76
76 76 47 47 47 47 47 47 47 47 47 47 47 47 76 76
76 76 47 47 47 47 47 47 47 47 47 47 47 47 76 76
76 76 47 47 47 47 47 47 47 47 47 47 47 47 76 76
76 76 47 47 47 47 47 47 47 47 47 47 47 47 76 76
76 76 73 73 73 73 73 47 47 73 73 73 73 73 76 76
76 76 76 76 76 76 76 47 47 76 76 76 76 76 76 76
