5 5 5 5 5 5 5 5 5 5 5 5 5 5 5 5
5 5 6 0 0 0 0 0 0 4 5 5 5 5 5 5
5 6 0 0 0 0 0 0 0 0 4 5 5 5 5 5
6 0 0 1 2 3 0 1 3 0 0 4 5 5 5 5
0 0 0 4 5 6 0 4 6 0 0 0 5 5 5 5
0 0 0 0 0 0 0 0 0 0 0 0 5 5 5 5
0 0 0 1 2 3 0 7 0 7 0 0 5 5 5 5
0 0 0 4 5 6 0 0 0 0 0 0 5 5 5 5
3 0 0 0 0 0 0 7 0 7 0 1 5 5 5 5
5 3 0 0 0 0 0 0 0 0 1 5 5 5 5 5
5 5 2 2 2 2 2 2 2 2 5 5 5 5 5 5
5 5 5 5 5 5 5 5 5 5 5 5 5 5 5 5