0 0 6 1 1 4 1 1 1 1 1 1
0 0 6 1 0 0 0 0 0 0 0 0
2 1 1 5 0 0 0 0 0 0 0 0
3 4 0 3 0 0 0 1 0 2 0 0
0 0 6 1 0 0 0 0 0 0 0 0
0 0 6 1 0 0 0 1 4 0 0 0
2 1 1 5 0 0 0 2 3 0 0 0
3 4 0 3 0 0 0 0 0 0 0 0
0 0 6 1 0 0 0 0 0 0 0 0
0 0 6 1 0 0 0 0 0 0 0 0
2 1 1 5 0 0 0 0 0 0 0 0
3 4 0 3 0 0 0 0 0 0 0 0